BBBBBBBBBBBBBBBBBBBBBBBBBBBBB
B                           B
B                           B
B                           B
B                           B
B                           B
B                           B
B                           B
B                           B
B                           B
B                           B
B                           B
B                           B
B                           B
B                           B
B                           B
B                           B
B                           B
B                    GG     B
BGGGGGGGGGGGGGGGGGGGGGGGGGGGB