BBBBBBBBBBBBBBBBBBBBBBBBBBBBB
B                           B
B                           B
B                           B
B                           B
B                           B
B                           B
B                           B
B                           B
B                           B
B                           B
B                           B
B                           B
B                           B
B                           B
B                           B
B          GQG              B
B                    GG     B
B                G   GG     B
GGGGGGGGGGGGGGGGGGGGGGGGG  GG